111111111111
1CE100000001
1000P0000001
100100000001
100100001111
100100001001
111111111111