111111111111
1P0000000001
100000000001
100000000001
100000000001
100000000001
100000000001
100000000001
100000000001
100000001111
100000001CE1
111111111111