1111111111111111111111111111111111
100000000000000C00000C000100000001
1100111100100000101001000100010101
1P11000010101010001001000100000001
1010010010101010001001000100010101
1010010010101010001001000100000001
1010010010101010001001000100010101
1010001010101010001001000100010101
100001000C00C0000000000000010000C1
100001000C00C0000C00000000010000C1
100001000C00C000CEC0000000010000C1
100001000C00C0000C00000000010000C1
100001000C00C0000000000000010000C1
100001000C00C0000000000000010000C1
100001000C00C0000000000000010000C1
100001000C00C0000000000000010000C1
100001000C00C0000000000000010000C1
100001000C00C0000000000000010000C1
100001000C00C0000000000000010000C1
10000X000C00C0000000000000010000C1
100001000C00C0000000000000010000C1
100001000C00C0000000000000010000C1
100001000C00C0000000000000010000C1
100001000C00C0000000000000010000C1
100001000C00C0000000000000010000C1
100001000C00C0000000000000010000C1
100001000C00C0000000000000010000C1
100001000C00C0000000000000010000C1
100001000C00C0000000000000010000C1
100001000C00C0000000000000010000C1
1111111111111111111111111111111111
